1111111
1m001e1
1010101
1000001
1111111

11111
1m0e1
10101
10001
11111

111111111
1m0000001
101111101
100000001
111011101
1000000e1
111111111

111111
1m0001
111001
100001
10e101
111111

111111111111
1m0000000001
101111111101
100000000001
111101111101
1000010000e1
111111111111
